N N N N N
E N E N E
N E N E N
X N E N X
X X X X X